xxxxxxxxxxxxxxxx
x x p x x   xspx
x x x xpx v x  x
x x x x   x pv x
x x xsx x x    x
xsx x x x x xp x
x x xpx x xvx  x
xpx x x x xpx px
x x x v x x x vx
x   xs  x s x fx
x vsx psxp pp vx
xxxxxxxxxxxxxxxx